1

8 8
4 2
1
4 3
++++....
+..+....
+..+++++
+......+
++W*+#.+
+...+..+
+...++++
+++++...
0
0
0
0
0
0
