Nivel_6
9 9
+++++++++
+.......+
+..++.+.+
+.W.#.#.+
+..++++.+
+..*.*..+
+.......+
+.......+
+++++++++