Level_2
8 8
++++++++
+......+
+..W...+
+..**..+
+.##...+
+......+
+......+
++++++++
