Level_8
12 12
++++++++++++
+......+...+
+..#.*.#*..+
+..*..+...W+
+.+....#...+
+...#.+.+..+
+..#...#...+
+..+..+....+
+....#*#...+
+.#..*..#..+
+...+......+
++++++++++++