Level_6
12 12
++++++++++++
+...+......+
+W..*#.#...+
+..#....+..+
+.+..*#...#+
+...+.+....+
+#.#....*..+
+..*..+....+
+....#..#..+
+.+#...*..#+
+.....+....+
++++++++++++