Nivel_4
8 8
++++++++
+..+...+
+..+.+W+
+..#...+
+.+.*..+
+......+
+......+
++++++++
