Level_10
9 9
+++++++++
+.+.+.+.+
+.......+
+.+*+#+.+
+.......+
+.+#+.+.+
+....*..+
+.+W+.+.+
+++++++++
