Level_5
8 8
++++....
+.W++...
+...+++.
+###..+.
+***..+.
+..+..+.
+..+..+.
+++++++.