Level_7
10 10
++++++++++
+....*...+
+..+..+..+
+..+..+..+
+..+.....+
+..++.#.*+
+....#..++
+...W....+
+........+
++++++++++