Level_2
10 10
++++++++++
+........+
+...+....+
+..++.W+.+
+.....++.+
+.++.*.+.+
+..#.+.+.+
+..+...+.+
+..+...+.+
++++++++++