Level_9
12 12
++++++++++++
+....*.....+
+...+.+....+
+..+...+...+
+..+...+...+
+..++#++...+
+......#...+
+..+++...*.+
+....+.....+
+....#..*..+
+.W..+.....+
++++++++++++
