Level_1
8 8
++++++++
+......+
+......+
+...*..+
+..#W..+
+......+
+......+
++++++++