Nivel_4
10 10
++++++++++
+.......#+
+.#+#.#.*+
+.#.+.#.#+
+.#.#+#.#+
+.*...W..+
+.#+#+#..+
+.+..#.#.+
+.+#.#.##+
++++++++++
