Nivel_5
10 10
++++++++++
+....*...+
+..#+#...+
+.#.+#.#.+
+.#+W#.#.+
+.#..#+#.+
+.*.#..#*+
+.#+#+#+.+
+....#...+
++++++++++
