Level_10
14 14
++++++++++++++
+............+
+.*..#..*..#.+
+.W..........+
+..#..+.+.+..+
+..+..#.#..+.+
+..#.*...*#..+
+.+.#..+.+...+
+..#...#*..+.+
+.*..#..+..#.+
+..+....+....+
+.#..*.*..#.++
+............+
++++++++++++++
