Level_7
12 12
++++++++++++
+..........+
+.#..#.*..W+
+.+..+.....+
+...#..#*..+
+.#...*#...+
+....+.....+
+..#.+#....+
+*...*..#..+
+....+.+...+
+.........+.+
++++++++++++