Level_2
15 15
+++++++++++++++
+.............+
+.*..#.#.#*..W+
+.............+
+.+.+.+..+..+.+
+..#..#..#....+
+.....+..+..+.+
+.#*#*#*#*#*#.+
+.+..+..+..+.+.+
+....#..#..#..+
+.+.+..+..+.+.+
+.............+
+.#*#.#.#*#*#.+
+.............+
+++++++++++++++
