8 8
1 2
1
4 3
++++....
+.W+....
+..+++++
+......+
++.*+#.+
+...+..+
+...++++
+++++...
0
3
3
