8 8
2 3
2
3 3
3 4
++++++++
+......+
+..W...+
+..@*..+
+...#..+
+......+
+......+
++++++++
5
17
23
