10 10
6 1
3
1 5
6 2
6 8
++++++++++
+#...*...+
+..#+#...+
+.#.+#.#.+
+.#+.#.#.+
+....#+#.+
+W@.#..#*+
+..+#+#+.+
+....#...+
++++++++++
6
45
58
