8 8
5 5
2
3 3
3 4
++++++++
+......+
+......+
+..**..+
+.##...+
+....W.+
+......+
++++++++
0
5
5
