8 8
4 6
1
4 3
++++....
+..+....
+..+++++
+......+
++.*+#W+
+...+..+
+...++++
+++++...
0
6
6
