10 10
5 2
3
1 5
6 2
6 8
++++++++++
+....*...+
+..#+#...+
+.#.+#.#.+
+.#+.#.#.+
+.W#.#+#.+
+.*.#..#*+
+.#+#+#+.+
+....#...+
++++++++++
1
6
7
