15 15
2 11
10
2 2
2 10
7 3
7 5
7 7
7 9
7 11
12 3
12 9
12 11
+++++++++++++++
+.............+
+.*..#.#.#*W..+
+.............+
+.+.+.+..+..+.+
+..#..#..#....+
+.....+..+..+.+
+.#*#*#*#*#*#.+
+.+..+..+..+.+.
+....#..#..#..+
+.+.+..+..+.+.+
+.............+
+.#*#.#.#*#*#.+
+.............+
+++++++++++++++
0
2
2
