8 8
3 3
1
4 3
++++....
+..+....
+..+++++
+..W...+
++.*+#.+
+...+..+
+...++++
+++++...
0
2
2