8 8
++++++++
+......+
+..#...+
+..*W..+
+.#....+
+......+
+......+
++++++++
