1
8 8
3 2
1
4 3
++++....
+..+....
+.#+++++
+.W....+
++.*+..+
+...+..+
+...++++
+++++...
5
12
17
