1
8 8
6 2
1
4 3
++++....
+..+....
+..+++++
+......+
++.*+..+
+..#+..+
+.W.++++
+++++...
9
25
34
