1
8 8
3 4
1
4 3
++++....
+..+....
+..+++++
+..#W..+
++.*+..+
+...+..+
+...++++
+++++...
3
10
13
0
0
0
