1
8 8
4 2
1
4 3
++++....
+..+....
+..+++++
+......+
++W*+..+
+.#.+..+
+...++++
+++++...
8
16
24
0
0
0
