3
8 8
3 3
2
3 3
3 4
++++++++
+......+
+......+
+..W*..+
+.##...+
+......+
+......+
++++++++
10
25
35
0
0
0
