1
8 8
3 5
1
4 3
++++....
+..+....
+..+++++
+....W.+
++.*+#.+
+...+..+
+...++++
+++++...
0
4
4
0
0
0
