1
8 8
3 5
1
4 3
++++....
+..+....
+..+++++
+...#W.+
++.*+..+
+...+..+
+...++++
+++++...
2
10
12
